__asm		TC_XX
__based 	TC_BASED
__builtin_isfloat	TC_XX
__cdecl 	TC_CDECL
__declspec	TC_DECLSPEC
__export	TC_EXPORT
__far		TC_FAR
__far16 	TC_FAR16
__fastcall	TC_FASTCALL
__fortran	TC_FORTRAN
__huge		TC_HUGE
__inline	TC_STG_CLASS
__interrupt	TC_INTERRUPT
__int64 	TC_KEYWORD
__loadds	TC_LOADDS
__near		TC_NEAR
_Packed 	TC_XX
__pascal	TC_PASCAL
__saveregs	TC_SAVEREGS
_Seg16		TC_SEG16
__segment	TC_SEGMENT
__segname	TC_SEGNAME
__self		TC_SELF
__stdcall	TC_STDCALL
_Syscall	TC_SYSCALL
_Optlink	TC_OPTLINK
__unaligned	TC_QUALIFIER
