accelerators	Y_ACCELERATORS
alt		Y_ALT
ascii		Y_ASCII
autocheckbox	Y_AUTOCHECKBOX
autoradiobutton Y_AUTORADIOBUTTON
auto3state	Y_AUTO3STATE
begin		Y_BEGIN
bitmap		Y_BITMAP
block		Y_BLOCK
button		Y_BUTTON
caption		Y_CAPTION
characteristics Y_CHARACTERISTICS
checkbox	Y_CHECKBOX
checked		Y_CHECKED
class		Y_CLASS
combobox	Y_COMBOBOX
code_page	Y_CODEPAGE
control		Y_CONTROL
ctext		Y_CTEXT
cursor		Y_CURSOR
defpushbutton	Y_DEFPUSHBUTTON
dialog		Y_DIALOG
dialogex        Y_DIALOG_EX
discardable	Y_DISCARDABLE
dlginit		Y_DLGINIT
edit		Y_EDIT
edittext	Y_EDITTEXT
end		Y_END
errtable	Y_ERRTABLE
exstyle		Y_EXSTYLE
fileflags	Y_FILEFLAGS
fileflagsmask	Y_FILEFLAGSMASK
fileos		Y_FILEOS
filesubtype	Y_FILESUBTYPE
filetype	Y_FILETYPE
fileversion	Y_FILEVERSION
fixed		Y_FIXED
font		Y_FONT
grayed		Y_GRAYED
groupbox	Y_GROUPBOX
help		Y_HELP
icon		Y_ICON
impure		Y_IMPURE
inactive	Y_INACTIVE
__includeres	Y_INCLUDERES
