language	Y_LANGUAGE
listbox		Y_LISTBOX
loadoncall	Y_LOADONCALL
ltext		Y_LTEXT
menu		Y_MENU
menuex          Y_MENU_EX
menubarbreak	Y_MENUBARBREAK
menubreak	Y_MENUBREAK
menuitem	Y_MENUITEM
messagetable	Y_MESSAGETABLE
moveable	Y_MOVEABLE
not		Y_NOT
noinvert	Y_NOINVERT
ownerdraw	Y_OWNERDRAW
popup		Y_POPUP
preload		Y_PRELOAD
productversion	Y_PRODUCTVERSION
pure		Y_PURE
pushbutton	Y_PUSHBUTTON
radiobutton	Y_RADIOBUTTON
rcdata		Y_RCDATA
rcinclude	Y_RCINCLUDE
rtext		Y_RTEXT
scrollbar	Y_SCROLLBAR
separator	Y_SEPARATOR
shift		Y_SHIFT
state3		Y_STATE3
static		Y_STATIC
stringtable	Y_STRINGTABLE
style		Y_STYLE
toolbar		Y_TOOLBAR
value		Y_VALUE
version		Y_VERSION
versioninfo	Y_VERSIONINFO
virtkey		Y_VIRTKEY
